0,12,16
0,1,3,4,6,7,8,9,10,12,14,18
3,6,9,14,15,16,17,18
1,3,5,6,11,12,13,14
5,8,9,10,11,16,17,18
0,1,2,3,7,8,11,13,14
3,4,5,11,14,15,16,18,19
9,18
3,4,5,6,7,8,9,10,11,12,13,14,15
0,1,2,3,15,16,17,18,19
